111111111111111111111111111111111111111111111111111111111111
1E00000000000000000000000000000000000000000000000000000000E1
100000000000000000000000000000000000000000000000000000000001
100000000000000000000000000000000000000000000000000000000001
100000000C00000000000000000000000000000000000000000000000001
100000000000000000000000000000000000000000000000000000000001
100000000000000000000000000000000000000000000000000000000001
100000000000000000000000000000000000000000000000000000000001
100000000000000000000000000000000000000000000000000000000001
100000000000000000000000000000000000000000000000000000000001
100000000000000000000000000000000000000000000000000000000001
10000000000000000000000000000000000C000000000000000000000001
100000000000000000000000000000000000000000000000000000000001
100000000000000000000000000000000000000010000000000000000001
10000000000000000000C000000000000000000010000000000000000001
100000000000000000000000000000000000000010000000000000000001
100000000000000000000000000000000000000010000000000000000001
100000000000011111000000000000000000000010000000000000000001
100000000000000000000000000000000000000010000000000000000001
1000000000000000000000000000000000000000C0000000000000000001
100000000000000000000000000000000000000000000000000000000001
100000000000000000000000000000000000000000000000000000000001
100000000000000C00000000000000000000000000000000000000000001
100000000000000000000000000000000000000000000000000000000001
100000000000000000000000000000000000000000000000000000000001
1C0000000000000000000000000000000000000000000000000000000001
1C0000000000000000000000000000000000000000000000000000000001
1000000000000000000000000000000C0000000000000000000000000001
1000000000000000000000000000000C0000000000000000000000000001
1000000000000000000000000000000C0000000000000000000000000001
100000000000000000000000000000000000000000000000000000000001
1P00000000000000000000000000000000000000000000000000000C00E1
111111111111111111111111111111111111111111111111111111111111
