11111111111111111111111111111111111111111111111111
1P000000000000000000000000000000000000000000000001
10111111111111111111111111111111111111111111111001
10000000000000000000000000000000000000000000000001
10001111111111111111111111111111111111111111111101
10000000000000000000000000000000000000000000000001
10111111111111111111111111111111111111111111111001
10000000000000000000000000000000000000000000000001
11111111111111111111111111111111111111111111111101
1C000000000000000000000000000000000000000000C00001
10111111111111111111111111111111111111111111111101
10000000000000000000000000000000000000000000000001
10111111111111111111111111111111111111111111111001
10000000000000000000000000000000000000000000000001
11111111110011111111111111111111111111111111111111
1C000000000000000000000000000000000000000000E00001
11111111111111111111001111111111111111111111111101
1C000000000000000000000000000000000000000000000001
10111111111111111111111111111111111111111111111001
10000000000000000000000000000000000000000000000001
10001111111111111111111111111111111111111111111101
10000000000000000000000000000000000000000000000001
10111111111111111111111111111111111111111111111001
10000000000000000000000000000000000000000000000001
11111111111111111111111111111111001111111111111111
1C000000000000000000000000000000000000000000C00001
10111111111111111111111111111111111111111111111101
10000000000000000000000000000000000000000000000001
11111111111111110111111111111110111111111111111111
1C000000000000000000000000000000000000000000000001
10111111111111111111111111111111111111111111111001
10000000000000000000000000000000000000000000000001
11111111111111111111111111111111111111111111111101
1C000000000000000000000000000000000000000000C00001
10111111111111111111111111111111111111111111111101
10000000000000000000000000000000000000000000000001
11111111111111111111111111111111111111111111111111
