1111111
111E111
1110111
1C00001
100C001
10000C1
111P111
1111111
1111111
