1111111111111
100C000C00001
1000110000001
1P010C10000E1
1111111111111
