1111111111111
10011000CCCC1
1000011111CC1
1P0011E000001
1111111111111
