1111111111
1P000C0001
1011111011
1000X00011
1111011111
1C00000001
1E11111111
1111111111
