111111111111111111
1P000000000C0001
1011111111111011
100000000000001111
1111011111111111
1C000000000E0001
111111111111111111
